"0","table(stops$race)"
"1","
"
"1","   A "
"1","   B "
"1","   H "
"1","   W "
"1","
"
"1","  71 "
"1","2035 "
"1"," 444 "
"1","2808 "
"1","
"
